
NO misc/textures/hospital.xpm
SO misc/textures/brick_wall_damaged.xpm
WE misc/textures/blblbl.xpm
EA misc/textures/Texturelabs_Metal.xpm

C 92, 138, 133
F 163, 138, 133

11111111111111111111111111111111111111111111111111111111111111111111111  
110000000000000000000000000011111000000000000000000000000000000000000011 
110000000000000000000000000011111000000000000000000000000000000000000011 
110000000000000001000000000011111000000000000000000000000000000000000011 
110000000000000110000000000011111000000000000000000011111111111111111111 
110000000000011000000000000011111000000000000000000010000000000000000011 
110000000001100000000000000011111000000000000000000010000000000000000011 
110000000110000000000000000000000000000000000000000010000000000000000011 
110000011000000000000000000000000000000000000000000010000000000000000011 
110000100000000000000000000000000000000000000000000010000000000000000011 
110000000000000000000000000000000000000000000000000000000000000000000011 
1100000000111111111111000000000000000111111000000000000000000000000000111
1100000000100000000001000000000000000100000111110000000000000000000000111
110000000010000000000100000000000000010000000000111000000000N000000000111
1100000000100000000001000000000000000100000000000001100000000000000000111
1100000000100000000001000000000000000100000000000000011000000000000000111
1100000000100000000001000000000000000100000000000000000000000000000000111
1100000000111111111111000000000000000100000000000000000000000000000000111
1111111111111111111111111111111111111111111111111111111111111111111111111
1111111111111111111111111111111111111111111111111111111111111111111111111
