
NO misc/textures/Texturelabs_Sky.xpm
SO misc/textures/space.xpm
WE misc/textures/Texturelabs_Metal.xpm
EA misc/textures/Texturelabs_Details.xpm

F 92, 138, 133
C 163, 138, 133

11111111111111111111111111111111111111111111111111111111111111111111111111111111
10000000000000000000000000000000000000000000000000000000000000000000000000000001
10000000N00000000000000000000000000000000000000000000000000000000000000000000001
10000000000000000000000000000000000000000000000000000000000000000000000000000001
10000000000000000000000000000000000000000000000000000000000000000000000000000001
10000000000000000000000000000000000000000000000000000000000000000000000000000001
10000000000000000000000000000000000000001111111111111111000000000000000000000001
10000000111111111111110000000000000000010000000000000000100000000000000000000001
10000000000000000000000000000000000000000000000000000000010000000000000000000001
10000000000000000000000000000000000000000000000000000000010000000000000000000001
11111111111111111111111111111111111111111111111111111111111111111111111111111111
