C   69, 222, 199

NO misc/textures/grassycliff.xpm
SO misc/textures/hospital.xpm
WE misc/textures/brick-wall-red.xpm
EA misc/textures/blblbl.xpm


F 235, 198, 52

111111111111111111111111
100000000000000000000001
100N00000000000000000001
100000000000000000000001
100000000000000000000001
100000000000000000000001
100000000000000000000001
100000111110000101010001
100000100010000000000001
100000100010000100010001
100000100010000000000001
100000111100001010100001
100000000000000000000001
100000000000000000000001
100000000000000000000001
100000000000000000000001
100000000000000000000001
100000000000000000000001
100000000000000000000001
100000000000000000000001
100000000000000000000001
100000111110000000000001
100000100010000000000001
100000100010000000000001
100000100010000000000001
100000111110001010100001
111111111111111111111111

