NO misc/textures/hospital.xpm
SO misc/textures/blblbl.xpm
WE misc/textures/white_ceramic.xpm
EA misc/textures/space.xpm

F 220,100,4
C 254,30,0

1111111111111111111111111111
10000000000000000000001111111111
1100000000000000000000000000011
1111011000000001111100000000011
1100000000000000000000000000011
110000001111110000000000N0000011
1000000011110000000000000100011
111111111111111111111111111111