
NO misc/textures/grassycliff.xpm
SO misc/textures/hospital.xpm
WE misc/textures/brick-wall-red.xpm
EA misc/textures/blblbl.xpm

F   69, 222, 199
C 235, 198, 52

11111
11011
11S11
11011
11011
11111