

NO misc/textures/Texturelabs_Sky.xpm
SO misc/textures/Texturelabs_solar_plasma12.xpm
WE misc/textures/space.xpm
EA misc/textures/Texturelabs_Details.xpm

C 192, 192, 192
F 0, 0, 0

                     11111111111111111111111      
               11111110000000000000000000001      
               11111100000000000000000001111      
              110001100000001111111111110001      
              100001100000000000000000000011      
             110001110000000000000111111111       
             100000000000000000011                
      111111110000000000000000001                 
     1100000000000000001110000001                 
     100001110000000001  11111111                 
     110001110000000001                           
  1111100000000000000011111111111        111111   
1110010000000000000000000000000001111111110000011 
1000E00000000000000000000000000000000000000000001 
11100000000000001111111100000000000000000000000011
   11111111111111111111111111111111100000011111111
                                   1111111        