
NO misc/textures/hospital.xpm
SO misc/textures/blblbl.xpm
WE misc/textures/white_ceramic.xpm
EA misc/textures/space.xpm

F 92, 138, 133
C 163, 138, 133

11111111111111111111111111111111111111111111111111111111111111111111111111111111
10000000000000000000000000000000000000000000000000000000000000000000000000000001
10000000000000000000000000000000000000000000000000000000000000000000000000000001
10000000000000000000000000000000000000000000000000000000000000000000000000000001
10000000000000000000000000000000000000000000000000000000000000000000000000000001
10000000000000000000000000000000000000000000000000000000000000000000000000000001
10000000000000000000000000000000000000001111111111111111000000000000000000000001
10000000111111111111110000000000000000010000000000000000100000000000000000000001
10000000000000000000000000000000000000000000000000000000010000000000000000000001
10000000000000000000000000000000000000000000000000000000010000000000000000000001
10000000000000000000000000000000000000000000000000000000010000000000000000000001
10000000000000000000000000000000000000000000000000000000010000000000000000000001
10000000000000100000000000000000N00000000000000000000000010000000000000000000001
10000000000000100000000000000000000000000000000000000000010000000000000000000001
10000000000000100000000000000000000000001111111111111111100000000000000000000001
10000000000000100000000000000000000000010000000000000000000000000000000000000001
10000000000000100000000000000000000000010000000000000000000000000000000000000001
10000000000000100000000000000000000000001000000000000000000000000000000000000001
10000000000000100000000000000000000000000100000000000000010000000000000000000001
10000000000000111111111111111111100000000010000000000000100000000000000000000001
10000000000000000000000000000000000000000001000000000001000000000000000000000001
10000000000000000000000000000000000000000000111111111110000000000000000000000001
10000000000000000000000000000000000000000000000000000000000000000000000000000001
10000000000000000000000000000000000000000000000000000000000000000000000000000001
11111111111111111111111111111111111111111111111111111111111111111111111111111111