11111111111111111111111111111
10000000000000000000001111111111
11110111111111011100000010001
11000000110101011100N00010001
10000000000000000000000010001
11111111111111111111111111111