NO misc/textures/grassycliff.xpm
SO misc/textures/metal.xpm
WE misc/textures/grassycliff.xpm
EA misc/textures/metal.xpm

F 220,100,4
C 254,30,0
 
 11111111111111111111111111111111111111111111111111 
 10000000000000000000000000000000000000000000000001 
 10000000000000000000000000000000000000000000000001 
 10000000000000000000000000000000000000000000000001 
 10000000000000000000000000000000000000000000000001 
 10000000000000000000000000000000000000000000000001 
 10000000000000000000000000000000000000000000000001 
 10000000000000000000000000000000000000000000000001 
 10000000000000000000000000000000000000000000000001 
110000000000000000000000000000000000000000000000001 
100000000000000000000000000000000000000000000000001 
1000000000000000000000000000000000000000000000000001
1000000000000000000000000000000000000000000000000001
1000000000000000000000000000000000000000000000000001
1111000000000111111111111111111111111111111111111111
   1111111111                                       