   NO ./texture.xpm      

111111111111111111111
100000000000000000001
100000000000000000001
100000000000000000001
100000011111000000001
100000011111000000001
100000011111000000001
100000000000000000001
100000000000000000001
100000000000000000001
10000000000W000000001
100000000000000000001
111111111111111111111
