
F 220, 100,4 


NO misc/textures/grassycliff.xpm
SO misc/textures/metal.xpm
WE misc/textures/grassycliff.xpm
EA misc/textures/metal.xpm

C 254, 99 ,0
 
 11111111111111111111111111111111111111111111111111 
 10000000000000000000000000000000000000000000000001 
 10000000000000000000000000000000000000000000000001 
 100000000000000000000000000000000000000000000000011 
 100000000000000000000000000000000000000000000000011 
 100000000000000000000000000000000000000000000000011
 10000000000000000000000000000000000000000000000001 
 10000000000000000000N00000000000000000000000000001 
 10000000000000000000000000000000000000000000000001 
110000000000000000000000000000000000000000000000001 
100000000000000000000000000000000000000000000000001 
1000000000000000000000000000000000000000000000000001
1000000000000000000000000000000000000000000000000001
1000000000000000000000000000000000000000000000000001
1111000000000111111111111111101111111111111111111111
   1111111111   1111111111111011111111111
                            1111





