
NO misc/textures/grassycliff.xpm
SO misc/textures/hospital.xpmm
WE misc/textures/grassycliff.xpm
EA misc/textures/blblbl.xpm

F 220,100,4
C 254,30,0

1111111111111111111111111
1000000000110000000000001
1011000001110000000000001
110010W000000000000000001
1111111110110000011100001
1000000000110000011111111
1111011111011100000010001
1111011111011101010010001
1100010101011100000000001
1000000000000000000010001
1000000000001101010010001
1100010101111101111000111
1111111111111111111111111
