NO misc/textures/grassycliff.xpm
SO misc/textures/hospital.xpm
WE misc/textures/grassycliff.xpm
EA misc/textures/blblbl.xpm

F 20,20,20
C 200,200,200

110111
100001
100001
100001
100001
100001
110001
100001
10W001
100001
100001
100001
111111